DATE,Year,Day,Drugs,Theft,Violent,Others,Total
1/1/2018,2018,1,17,231,267,188,703
1/2/2018,2018,2,25,207,163,112,507
1/3/2018,2018,3,34,221,158,95,508
1/4/2018,2018,4,22,212,191,91,516
1/5/2018,2018,5,28,242,223,104,597
1/6/2018,2018,6,21,169,231,78,499
1/7/2018,2018,7,18,182,214,58,472
1/8/2018,2018,8,43,229,192,77,541
1/9/2018,2018,9,48,230,191,87,556
1/10/2018,2018,10,46,241,236,95,618
1/11/2018,2018,11,35,211,255,110,611
1/12/2018,2018,12,40,244,235,103,622
1/13/2018,2018,13,26,199,225,93,543
1/14/2018,2018,14,22,180,228,70,500
1/15/2018,2018,15,35,175,164,87,461
1/16/2018,2018,16,33,212,202,102,549
1/17/2018,2018,17,39,205,221,87,552
1/18/2018,2018,18,31,215,194,96,536
1/19/2018,2018,19,49,231,220,112,612
1/20/2018,2018,20,49,249,253,92,643
1/21/2018,2018,21,41,229,282,77,629
1/22/2018,2018,22,37,255,229,97,618
1/23/2018,2018,23,42,240,235,103,620
1/24/2018,2018,24,43,188,208,92,531
1/25/2018,2018,25,35,209,250,83,577
1/26/2018,2018,26,45,218,283,99,645
1/27/2018,2018,27,45,241,265,103,654
1/28/2018,2018,28,37,191,272,86,586
1/29/2018,2018,29,23,240,207,115,585
1/30/2018,2018,30,30,214,211,90,545
1/31/2018,2018,31,44,249,232,90,615
2/1/2018,2018,32,34,226,207,176,643
2/2/2018,2018,33,50,221,190,121,582
2/3/2018,2018,34,41,182,219,107,549
2/4/2018,2018,35,16,137,226,68,447
2/5/2018,2018,36,22,170,189,94,475
2/6/2018,2018,37,40,183,187,95,505
2/7/2018,2018,38,36,161,167,91,455
2/8/2018,2018,39,43,167,170,114,494
2/9/2018,2018,40,17,154,174,85,430
2/10/2018,2018,41,30,168,194,80,472
2/11/2018,2018,42,28,132,230,75,465
2/12/2018,2018,43,50,160,203,95,508
2/13/2018,2018,44,40,211,205,106,562
2/14/2018,2018,45,42,179,261,104,586
2/15/2018,2018,46,52,201,254,116,623
2/16/2018,2018,47,26,211,248,92,577
2/17/2018,2018,48,11,201,247,90,549
2/18/2018,2018,49,19,160,257,58,494
2/19/2018,2018,50,30,188,242,89,549
2/20/2018,2018,51,33,163,232,121,549
2/21/2018,2018,52,40,206,222,96,564
2/22/2018,2018,53,38,206,251,93,588
2/23/2018,2018,54,53,214,222,100,589
2/24/2018,2018,55,32,195,289,85,601
2/25/2018,2018,56,31,207,273,78,589
2/26/2018,2018,57,45,171,233,94,543
2/27/2018,2018,58,55,197,231,108,591
2/28/2018,2018,59,42,190,204,118,554
3/1/2018,2018,60,36,214,289,189,728
3/2/2018,2018,61,51,200,248,110,609
3/3/2018,2018,62,42,183,282,89,596
3/4/2018,2018,63,46,191,262,85,584
3/5/2018,2018,64,47,191,244,100,582
3/6/2018,2018,65,42,190,234,119,585
3/7/2018,2018,66,50,211,201,107,569
3/8/2018,2018,67,36,167,241,104,548
3/9/2018,2018,68,43,225,252,115,635
3/10/2018,2018,69,42,203,274,89,608
3/11/2018,2018,70,36,176,272,62,546
3/12/2018,2018,71,35,215,229,94,573
3/13/2018,2018,72,34,200,242,90,566
3/14/2018,2018,73,46,184,258,90,578
3/15/2018,2018,74,38,216,254,109,617
3/16/2018,2018,75,50,198,263,99,610
3/17/2018,2018,76,47,214,342,90,693
3/18/2018,2018,77,34,194,276,106,610
3/19/2018,2018,78,40,204,231,105,580
3/20/2018,2018,79,46,192,252,124,614
3/21/2018,2018,80,36,198,258,108,600
3/22/2018,2018,81,39,208,229,111,587
3/23/2018,2018,82,57,219,274,102,652
3/24/2018,2018,83,28,210,248,78,564
3/25/2018,2018,84,43,179,292,77,591
3/26/2018,2018,85,40,220,227,122,609
3/27/2018,2018,86,32,209,248,103,592
3/28/2018,2018,87,52,206,246,94,598
3/29/2018,2018,88,40,181,226,99,546
3/30/2018,2018,89,35,232,234,113,614
3/31/2018,2018,90,39,195,286,86,606
4/1/2018,2018,91,31,200,253,154,638
4/2/2018,2018,92,42,204,246,98,590
4/3/2018,2018,93,43,180,191,108,522
4/4/2018,2018,94,34,217,247,113,611
4/5/2018,2018,95,33,195,246,117,591
4/6/2018,2018,96,36,197,253,107,593
4/7/2018,2018,97,41,172,284,68,565
4/8/2018,2018,98,35,201,246,87,569
4/9/2018,2018,99,38,205,238,107,588
4/10/2018,2018,100,51,216,231,113,611
4/11/2018,2018,101,38,230,289,93,650
4/12/2018,2018,102,34,224,294,101,653
4/13/2018,2018,103,49,257,271,117,694
4/14/2018,2018,104,30,231,240,95,596
4/15/2018,2018,105,27,194,242,75,538
4/16/2018,2018,106,21,226,274,94,615
4/17/2018,2018,107,31,220,229,114,594
4/18/2018,2018,108,22,203,218,102,545
4/19/2018,2018,109,43,212,225,123,603
4/20/2018,2018,110,54,247,277,109,687
4/21/2018,2018,111,44,187,281,83,595
4/22/2018,2018,112,35,197,296,76,604
4/23/2018,2018,113,25,218,260,112,615
4/24/2018,2018,114,27,234,264,92,617
4/25/2018,2018,115,39,243,261,100,643
4/26/2018,2018,116,32,246,237,136,651
4/27/2018,2018,117,56,225,272,106,659
4/28/2018,2018,118,37,231,234,96,598
4/29/2018,2018,119,42,212,291,83,628
4/30/2018,2018,120,31,219,293,129,672
5/1/2018,2018,121,31,284,367,217,899
5/2/2018,2018,122,45,244,285,114,688
5/3/2018,2018,123,36,207,296,115,654
5/4/2018,2018,124,57,227,324,88,696
5/5/2018,2018,125,36,261,369,100,766
5/6/2018,2018,126,24,199,339,69,631
5/7/2018,2018,127,44,253,290,112,699
5/8/2018,2018,128,34,230,297,116,677
5/9/2018,2018,129,26,241,300,103,670
5/10/2018,2018,130,36,246,271,120,673
5/11/2018,2018,131,41,212,273,95,621
5/12/2018,2018,132,34,210,275,89,608
5/13/2018,2018,133,32,203,310,63,608
5/14/2018,2018,134,33,241,304,111,689
5/15/2018,2018,135,25,244,280,116,665
5/16/2018,2018,136,39,218,315,89,661
5/17/2018,2018,137,29,260,304,101,694
5/18/2018,2018,138,47,244,262,136,689
5/19/2018,2018,139,53,241,292,80,666
5/20/2018,2018,140,35,223,312,103,673
5/21/2018,2018,141,50,232,248,102,632
5/22/2018,2018,142,39,224,305,123,691
5/23/2018,2018,143,37,239,299,115,690
5/24/2018,2018,144,50,238,302,113,703
5/25/2018,2018,145,26,227,334,124,711
5/26/2018,2018,146,42,246,384,83,755
5/27/2018,2018,147,46,234,404,84,768
5/28/2018,2018,148,48,245,361,99,753
5/29/2018,2018,149,33,274,356,112,775
5/30/2018,2018,150,36,273,318,119,746
5/31/2018,2018,151,33,251,312,121,717
6/1/2018,2018,152,43,297,324,192,856
6/2/2018,2018,153,50,241,322,118,731
6/3/2018,2018,154,37,255,353,83,728
6/4/2018,2018,155,30,243,300,126,699
6/5/2018,2018,156,37,250,268,107,662
6/6/2018,2018,157,35,269,292,134,730
6/7/2018,2018,158,35,229,308,105,677
6/8/2018,2018,159,46,234,285,92,657
6/9/2018,2018,160,40,275,308,79,702
6/10/2018,2018,161,38,261,274,65,638
6/11/2018,2018,162,39,246,258,113,656
6/12/2018,2018,163,32,257,294,111,694
6/13/2018,2018,164,33,231,294,97,655
6/14/2018,2018,165,39,238,282,83,642
6/15/2018,2018,166,42,240,293,152,727
6/16/2018,2018,167,32,254,343,90,719
6/17/2018,2018,168,20,235,397,78,730
6/18/2018,2018,169,29,262,339,110,740
6/19/2018,2018,170,35,236,312,103,686
6/20/2018,2018,171,43,283,319,114,759
6/21/2018,2018,172,31,236,200,115,582
6/22/2018,2018,173,44,238,253,89,624
6/23/2018,2018,174,37,279,321,94,731
6/24/2018,2018,175,20,286,369,81,756
6/25/2018,2018,176,34,288,308,108,738
6/26/2018,2018,177,31,268,289,106,694
6/27/2018,2018,178,39,273,284,113,709
6/28/2018,2018,179,33,275,289,117,714
6/29/2018,2018,180,31,253,293,97,674
6/30/2018,2018,181,46,279,339,102,766
7/1/2018,2018,182,56,257,354,170,837
7/2/2018,2018,183,37,277,324,123,761
7/3/2018,2018,184,55,253,276,109,693
7/4/2018,2018,185,36,206,395,68,705
7/5/2018,2018,186,63,240,323,96,722
7/6/2018,2018,187,64,273,296,137,770
7/7/2018,2018,188,41,254,334,110,739
7/8/2018,2018,189,39,217,379,80,715
7/9/2018,2018,190,34,258,288,114,694
7/10/2018,2018,191,37,280,280,112,709
7/11/2018,2018,192,24,235,270,103,632
7/12/2018,2018,193,43,279,279,105,706
7/13/2018,2018,194,34,291,301,94,720
7/14/2018,2018,195,36,232,335,80,683
7/15/2018,2018,196,30,248,338,101,717
7/16/2018,2018,197,40,240,294,116,690
7/17/2018,2018,198,40,236,277,95,648
7/18/2018,2018,199,29,260,320,128,737
7/19/2018,2018,200,25,275,268,117,685
7/20/2018,2018,201,38,282,281,132,733
7/21/2018,2018,202,37,243,341,83,704
7/22/2018,2018,203,45,246,317,82,690
7/23/2018,2018,204,35,270,319,114,738
7/24/2018,2018,205,34,256,304,111,705
7/25/2018,2018,206,47,251,299,110,707
7/26/2018,2018,207,38,265,278,105,686
7/27/2018,2018,208,42,234,287,113,676
7/28/2018,2018,209,30,251,308,98,687
7/29/2018,2018,210,28,249,318,73,668
7/30/2018,2018,211,22,282,261,117,682
7/31/2018,2018,212,35,259,310,134,738
8/1/2018,2018,213,35,291,305,178,809
8/2/2018,2018,214,26,336,282,98,742
8/3/2018,2018,215,38,338,283,136,795
8/4/2018,2018,216,37,305,351,79,772
8/5/2018,2018,217,19,269,373,92,753
8/6/2018,2018,218,37,271,256,119,683
8/7/2018,2018,219,41,288,238,113,680
8/8/2018,2018,220,38,276,257,120,691
8/9/2018,2018,221,32,258,272,96,658
8/10/2018,2018,222,48,297,277,108,730
8/11/2018,2018,223,43,270,336,89,738
8/12/2018,2018,224,47,230,376,99,752
8/13/2018,2018,225,34,279,286,125,724
8/14/2018,2018,226,48,290,295,97,730
8/15/2018,2018,227,41,278,262,102,683
8/16/2018,2018,228,39,279,304,101,723
8/17/2018,2018,229,52,261,284,97,694
8/18/2018,2018,230,50,281,334,117,782
8/19/2018,2018,231,43,231,335,85,694
8/20/2018,2018,232,37,239,242,110,628
8/21/2018,2018,233,41,241,246,99,627
8/22/2018,2018,234,41,283,309,95,728
8/23/2018,2018,235,27,251,271,91,640
8/24/2018,2018,236,49,259,266,110,684
8/25/2018,2018,237,60,253,324,103,740
8/26/2018,2018,238,47,217,363,72,699
8/27/2018,2018,239,38,283,288,105,714
8/28/2018,2018,240,41,257,295,111,704
8/29/2018,2018,241,34,253,247,122,656
8/30/2018,2018,242,48,276,270,102,696
8/31/2018,2018,243,63,258,272,118,711
9/1/2018,2018,244,69,267,322,169,827
9/2/2018,2018,245,62,236,319,91,708
9/3/2018,2018,246,55,229,300,93,677
9/4/2018,2018,247,51,255,294,111,711
9/5/2018,2018,248,37,232,264,94,627
9/6/2018,2018,249,51,237,247,100,635
9/7/2018,2018,250,53,233,219,120,625
9/8/2018,2018,251,38,262,301,80,681
9/9/2018,2018,252,23,218,275,78,594
9/10/2018,2018,253,21,258,237,106,622
9/11/2018,2018,254,39,210,253,91,593
9/12/2018,2018,255,30,226,265,94,615
9/13/2018,2018,256,33,228,243,94,598
9/14/2018,2018,257,44,269,322,113,748
9/15/2018,2018,258,44,246,323,85,698
9/16/2018,2018,259,47,247,346,67,707
9/17/2018,2018,260,25,275,270,117,687
9/18/2018,2018,261,29,239,271,92,631
9/19/2018,2018,262,31,251,281,85,648
9/20/2018,2018,263,35,260,323,104,722
9/21/2018,2018,264,29,270,301,113,713
9/22/2018,2018,265,41,280,326,66,713
9/23/2018,2018,266,34,239,303,79,655
9/24/2018,2018,267,37,275,268,106,686
9/25/2018,2018,268,23,253,280,93,649
9/26/2018,2018,269,35,254,268,95,652
9/27/2018,2018,270,32,239,228,94,593
9/28/2018,2018,271,49,256,264,109,678
9/29/2018,2018,272,44,264,257,69,634
9/30/2018,2018,273,35,251,283,82,651
10/1/2018,2018,274,36,268,292,183,779
10/2/2018,2018,275,26,265,240,98,629
10/3/2018,2018,276,20,222,267,83,592
10/4/2018,2018,277,18,225,274,103,620
10/5/2018,2018,278,22,203,241,103,569
10/6/2018,2018,279,13,249,306,73,641
10/7/2018,2018,280,23,219,322,67,631
10/8/2018,2018,281,32,218,299,90,639
10/9/2018,2018,282,40,220,284,99,643
10/10/2018,2018,283,40,219,273,109,641
10/11/2018,2018,284,38,232,227,83,580
10/12/2018,2018,285,42,234,241,112,629
10/13/2018,2018,286,36,252,263,77,628
10/14/2018,2018,287,25,216,308,65,614
10/15/2018,2018,288,28,239,252,111,630
10/16/2018,2018,289,29,227,232,99,587
10/17/2018,2018,290,43,209,219,108,579
10/18/2018,2018,291,37,242,242,94,615
10/19/2018,2018,292,43,258,270,96,667
10/20/2018,2018,293,33,258,310,100,701
10/21/2018,2018,294,31,207,261,72,571
10/22/2018,2018,295,37,217,273,89,616
10/23/2018,2018,296,39,227,282,105,653
10/24/2018,2018,297,42,272,290,97,701
10/25/2018,2018,298,31,232,284,90,637
10/26/2018,2018,299,49,265,286,105,705
10/27/2018,2018,300,26,258,310,85,679
10/28/2018,2018,301,31,230,298,73,632
10/29/2018,2018,302,36,226,256,101,619
10/30/2018,2018,303,54,243,273,104,674
10/31/2018,2018,304,49,248,368,114,779
11/1/2018,2018,305,35,275,312,197,819
11/2/2018,2018,306,61,260,256,105,682
11/3/2018,2018,307,44,244,299,101,688
11/4/2018,2018,308,24,225,270,89,608
11/5/2018,2018,309,40,201,247,105,593
11/6/2018,2018,310,40,243,252,118,653
11/7/2018,2018,311,42,234,221,95,592
11/8/2018,2018,312,34,233,234,94,595
11/9/2018,2018,313,49,243,238,91,621
11/10/2018,2018,314,35,211,239,75,560
11/11/2018,2018,315,29,198,261,74,562
11/12/2018,2018,316,44,217,243,90,594
11/13/2018,2018,317,43,215,178,96,532
11/14/2018,2018,318,43,227,191,99,560
11/15/2018,2018,319,44,237,200,109,590
11/16/2018,2018,320,63,234,237,109,643
11/17/2018,2018,321,43,216,232,92,583
11/18/2018,2018,322,30,187,250,87,554
11/19/2018,2018,323,28,205,233,101,567
11/20/2018,2018,324,37,250,213,105,605
11/21/2018,2018,325,52,267,236,91,646
11/22/2018,2018,326,14,153,241,53,461
11/23/2018,2018,327,46,237,278,100,661
11/24/2018,2018,328,31,263,222,90,606
11/25/2018,2018,329,15,174,252,67,508
11/26/2018,2018,330,24,175,201,97,497
11/27/2018,2018,331,34,238,200,100,572
11/28/2018,2018,332,44,237,228,110,619
11/29/2018,2018,333,48,240,232,98,618
11/30/2018,2018,334,43,234,256,102,635
12/1/2018,2018,335,36,260,263,155,714
12/2/2018,2018,336,31,226,282,83,622
12/3/2018,2018,337,31,265,240,113,649
12/4/2018,2018,338,51,248,215,122,636
12/5/2018,2018,339,35,225,228,132,620
12/6/2018,2018,340,33,259,244,93,629
12/7/2018,2018,341,39,243,258,118,658
12/8/2018,2018,342,38,255,279,89,661
12/9/2018,2018,343,27,225,283,76,611
12/10/2018,2018,344,38,243,218,112,611
12/11/2018,2018,345,30,230,224,100,584
12/12/2018,2018,346,39,274,238,124,675
12/13/2018,2018,347,24,219,225,114,582
12/14/2018,2018,348,41,271,271,108,691
12/15/2018,2018,349,34,257,282,87,660
12/16/2018,2018,350,46,233,295,90,664
12/17/2018,2018,351,36,268,228,96,628
12/18/2018,2018,352,32,259,210,123,624
12/19/2018,2018,353,36,263,258,96,653
12/20/2018,2018,354,21,310,248,117,696
12/21/2018,2018,355,30,309,253,108,700
12/22/2018,2018,356,16,269,294,85,664
12/23/2018,2018,357,25,203,271,63,562
12/24/2018,2018,358,16,206,223,84,529
12/25/2018,2018,359,8,102,233,45,388
12/26/2018,2018,360,41,209,211,87,548
12/27/2018,2018,361,27,227,202,81,537
12/28/2018,2018,362,55,251,229,92,627
12/29/2018,2018,363,38,204,277,81,600
12/30/2018,2018,364,32,212,272,76,592
12/31/2018,2018,365,21,225,242,75,563
1/1/2019,2019,1,36,212,405,230,883
1/2/2019,2019,2,49,205,209,107,570
1/3/2019,2019,3,53,252,246,115,666
1/4/2019,2019,4,68,246,238,111,663
1/5/2019,2019,5,75,221,276,103,675
1/6/2019,2019,6,39,192,267,76,574
1/7/2019,2019,7,36,201,233,105,575
1/8/2019,2019,8,46,203,260,97,606
1/9/2019,2019,9,55,208,197,98,558
1/10/2019,2019,10,46,191,235,104,576
1/11/2019,2019,11,65,255,236,119,675
1/12/2019,2019,12,48,203,233,99,583
1/13/2019,2019,13,36,160,222,54,472
1/14/2019,2019,14,30,211,227,84,552
1/15/2019,2019,15,45,210,232,121,608
1/16/2019,2019,16,55,227,211,122,615
1/17/2019,2019,17,37,211,214,109,571
1/18/2019,2019,18,36,216,221,105,578
1/19/2019,2019,19,30,149,184,72,435
1/20/2019,2019,20,23,135,200,77,435
1/21/2019,2019,21,42,183,175,86,486
1/22/2019,2019,22,45,188,200,98,531
1/23/2019,2019,23,81,220,202,79,582
1/24/2019,2019,24,41,179,208,89,517
1/25/2019,2019,25,50,175,183,97,505
1/26/2019,2019,26,40,162,197,69,468
1/27/2019,2019,27,38,156,194,75,463
1/28/2019,2019,28,36,136,198,99,469
1/29/2019,2019,29,35,166,169,71,441
1/30/2019,2019,30,9,96,134,64,303
1/31/2019,2019,31,15,154,171,79,419
2/1/2019,2019,32,62,216,204,183,665
2/2/2019,2019,33,55,221,252,105,633
2/3/2019,2019,34,31,165,255,69,520
2/4/2019,2019,35,40,214,279,97,630
2/5/2019,2019,36,46,197,220,98,561
2/6/2019,2019,37,49,185,235,88,557
2/7/2019,2019,38,47,203,248,90,588
2/8/2019,2019,39,62,215,193,97,567
2/9/2019,2019,40,62,223,264,108,657
2/10/2019,2019,41,37,180,258,82,557
2/11/2019,2019,42,42,204,196,88,530
2/12/2019,2019,43,48,199,239,99,585
2/13/2019,2019,44,44,188,225,101,558
2/14/2019,2019,45,46,213,279,123,661
2/15/2019,2019,46,58,225,248,126,657
2/16/2019,2019,47,40,212,253,102,607
2/17/2019,2019,48,38,191,250,63,542
2/18/2019,2019,49,33,190,215,76,514
2/19/2019,2019,50,40,169,216,105,530
2/20/2019,2019,51,42,198,217,104,561
2/21/2019,2019,52,44,220,236,101,601
2/22/2019,2019,53,57,197,228,120,602
2/23/2019,2019,54,56,191,241,84,572
2/24/2019,2019,55,33,174,202,66,475
2/25/2019,2019,56,44,194,201,92,531
2/26/2019,2019,57,32,182,220,105,539
2/27/2019,2019,58,54,186,221,107,568
2/28/2019,2019,59,29,191,186,112,518
3/1/2019,2019,60,60,198,207,183,648
3/2/2019,2019,61,54,184,251,84,573
3/3/2019,2019,62,37,135,227,86,485
3/4/2019,2019,63,44,153,189,107,493
3/5/2019,2019,64,46,161,179,93,479
3/6/2019,2019,65,49,181,219,113,562
3/7/2019,2019,66,49,192,204,102,547
3/8/2019,2019,67,58,197,259,99,613
3/9/2019,2019,68,52,166,257,73,548
3/10/2019,2019,69,43,156,268,75,542
3/11/2019,2019,70,42,217,247,109,615
3/12/2019,2019,71,44,186,222,99,551
3/13/2019,2019,72,38,191,277,99,605
3/14/2019,2019,73,44,173,251,114,582
3/15/2019,2019,74,53,210,277,101,641
3/16/2019,2019,75,45,199,332,97,673
3/17/2019,2019,76,26,159,276,67,528
3/18/2019,2019,77,42,175,273,87,577
3/19/2019,2019,78,47,176,247,84,554
3/20/2019,2019,79,46,199,226,126,597
3/21/2019,2019,80,39,218,264,90,611
3/22/2019,2019,81,57,211,249,100,617
3/23/2019,2019,82,44,197,285,78,604
3/24/2019,2019,83,32,188,275,77,572
3/25/2019,2019,84,47,181,226,110,564
3/26/2019,2019,85,46,197,240,103,586
3/27/2019,2019,86,43,164,275,110,592
3/28/2019,2019,87,44,189,270,100,603
3/29/2019,2019,88,49,201,257,91,598
3/30/2019,2019,89,49,185,252,76,562
3/31/2019,2019,90,39,165,272,78,554
4/1/2019,2019,91,37,212,265,180,694
4/2/2019,2019,92,48,178,238,114,578
4/3/2019,2019,93,49,187,245,115,596
4/4/2019,2019,94,42,191,256,102,591
4/5/2019,2019,95,60,217,264,86,627
4/6/2019,2019,96,41,196,291,104,632
4/7/2019,2019,97,44,185,297,79,605
4/8/2019,2019,98,46,202,296,110,654
4/9/2019,2019,99,50,182,280,86,598
4/10/2019,2019,100,35,218,212,107,572
4/11/2019,2019,101,45,218,265,108,636
4/12/2019,2019,102,59,226,263,122,670
4/13/2019,2019,103,44,216,310,97,667
4/14/2019,2019,104,31,144,226,75,476
4/15/2019,2019,105,44,227,253,126,650
4/16/2019,2019,106,39,195,280,122,636
4/17/2019,2019,107,39,216,242,93,590
4/18/2019,2019,108,34,181,240,84,539
4/19/2019,2019,109,56,196,226,83,561
4/20/2019,2019,110,45,204,295,84,628
4/21/2019,2019,111,37,154,320,52,563
4/22/2019,2019,112,42,176,306,110,634
4/23/2019,2019,113,51,236,261,101,649
4/24/2019,2019,114,40,200,248,115,603
4/25/2019,2019,115,34,214,300,107,655
4/26/2019,2019,116,50,229,272,116,667
4/27/2019,2019,117,29,187,266,69,551
4/28/2019,2019,118,37,168,262,61,528
4/29/2019,2019,119,40,237,243,102,622
4/30/2019,2019,120,43,228,266,98,635
5/1/2019,2019,121,35,235,289,154,713
5/2/2019,2019,122,36,212,251,99,598
5/3/2019,2019,123,58,258,260,107,683
5/4/2019,2019,124,36,183,309,78,606
5/5/2019,2019,125,26,200,365,92,683
5/6/2019,2019,126,37,237,296,112,682
5/7/2019,2019,127,37,217,257,104,615
5/8/2019,2019,128,40,211,300,106,657
5/9/2019,2019,129,48,202,279,104,633
5/10/2019,2019,130,46,214,298,123,681
5/11/2019,2019,131,46,235,257,65,603
5/12/2019,2019,132,26,171,265,87,549
5/13/2019,2019,133,31,223,314,120,688
5/14/2019,2019,134,40,207,282,92,621
5/15/2019,2019,135,31,241,292,102,666
5/16/2019,2019,136,40,232,275,92,639
5/17/2019,2019,137,58,201,305,102,666
5/18/2019,2019,138,32,231,314,97,674
5/19/2019,2019,139,44,189,362,96,691
5/20/2019,2019,140,36,236,307,115,694
5/21/2019,2019,141,38,208,275,113,634
5/22/2019,2019,142,41,209,316,109,675
5/23/2019,2019,143,44,217,310,88,659
5/24/2019,2019,144,47,247,312,128,734
5/25/2019,2019,145,33,232,374,103,742
5/26/2019,2019,146,38,204,375,86,703
5/27/2019,2019,147,37,218,297,93,645
5/28/2019,2019,148,32,232,274,108,646
5/29/2019,2019,149,26,223,290,91,630
5/30/2019,2019,150,37,223,277,105,642
5/31/2019,2019,151,43,245,324,108,720
6/1/2019,2019,152,47,246,337,152,782
6/2/2019,2019,153,26,221,326,70,643
6/3/2019,2019,154,41,206,260,106,613
6/4/2019,2019,155,36,214,313,104,667
6/5/2019,2019,156,45,247,300,109,701
6/6/2019,2019,157,38,227,270,116,651
6/7/2019,2019,158,59,233,313,110,715
6/8/2019,2019,159,46,300,341,88,775
6/9/2019,2019,160,27,241,352,77,697
6/10/2019,2019,161,34,262,303,112,711
6/11/2019,2019,162,44,245,305,80,674
6/12/2019,2019,163,39,235,262,96,632
6/13/2019,2019,164,41,218,277,82,618
6/14/2019,2019,165,41,243,319,100,703
6/15/2019,2019,166,38,233,345,110,726
6/16/2019,2019,167,28,193,335,81,637
6/17/2019,2019,168,32,215,296,107,650
6/18/2019,2019,169,45,224,277,88,634
6/19/2019,2019,170,70,225,293,122,710
6/20/2019,2019,171,38,224,276,109,647
6/21/2019,2019,172,64,239,283,112,698
6/22/2019,2019,173,38,260,324,86,708
6/23/2019,2019,174,37,236,363,89,725
6/24/2019,2019,175,41,234,322,122,719
6/25/2019,2019,176,36,257,281,106,680
6/26/2019,2019,177,34,265,303,107,709
6/27/2019,2019,178,46,252,264,88,650
6/28/2019,2019,179,45,276,316,103,740
6/29/2019,2019,180,46,268,349,108,771
6/30/2019,2019,181,28,255,378,64,725
7/1/2019,2019,182,38,281,323,145,787
7/2/2019,2019,183,44,219,287,120,670
7/3/2019,2019,184,51,249,288,124,712
7/4/2019,2019,185,34,186,369,85,674
7/5/2019,2019,186,47,230,375,115,767
7/6/2019,2019,187,35,214,332,106,687
7/7/2019,2019,188,36,208,352,83,679
7/8/2019,2019,189,43,269,297,113,722
7/9/2019,2019,190,47,219,277,99,642
7/10/2019,2019,191,46,271,300,106,723
7/11/2019,2019,192,25,223,317,104,669
7/12/2019,2019,193,51,239,285,117,692
7/13/2019,2019,194,36,241,370,83,730
7/14/2019,2019,195,37,227,352,79,695
7/15/2019,2019,196,48,254,297,110,709
7/16/2019,2019,197,32,237,283,103,655
7/17/2019,2019,198,48,275,262,105,690
7/18/2019,2019,199,34,259,268,101,662
7/19/2019,2019,200,43,251,296,108,698
7/20/2019,2019,201,43,264,307,93,707
7/21/2019,2019,202,30,225,337,86,678
7/22/2019,2019,203,32,261,278,103,674
7/23/2019,2019,204,36,282,259,101,678
7/24/2019,2019,205,33,278,249,87,647
7/25/2019,2019,206,41,269,277,118,705
7/26/2019,2019,207,63,261,281,104,709
7/27/2019,2019,208,43,268,323,78,712
7/28/2019,2019,209,53,239,357,62,711
7/29/2019,2019,210,51,252,303,114,720
7/30/2019,2019,211,50,257,256,109,672
7/31/2019,2019,212,31,250,242,96,619
8/1/2019,2019,213,57,314,266,160,797
8/2/2019,2019,214,52,340,279,113,784
8/3/2019,2019,215,50,295,327,91,763
8/4/2019,2019,216,42,289,347,68,746
8/5/2019,2019,217,43,249,318,92,702
8/6/2019,2019,218,49,235,291,99,674
8/7/2019,2019,219,68,256,271,83,678
8/8/2019,2019,220,44,275,265,125,709
8/9/2019,2019,221,39,266,279,100,684
8/10/2019,2019,222,25,229,334,78,666
8/11/2019,2019,223,35,246,336,76,693
8/12/2019,2019,224,45,256,248,83,632
8/13/2019,2019,225,48,240,256,109,653
8/14/2019,2019,226,50,241,294,105,690
8/15/2019,2019,227,44,250,302,110,706
8/16/2019,2019,228,62,230,263,100,655
8/17/2019,2019,229,41,256,329,75,701
8/18/2019,2019,230,37,193,341,86,657
8/19/2019,2019,231,48,239,278,125,690
8/20/2019,2019,232,47,218,275,115,655
8/21/2019,2019,233,56,251,234,97,638
8/22/2019,2019,234,37,239,275,114,665
8/23/2019,2019,235,59,262,270,87,678
8/24/2019,2019,236,45,249,328,79,701
8/25/2019,2019,237,43,210,359,71,683
8/26/2019,2019,238,41,218,252,104,615
8/27/2019,2019,239,44,238,260,89,631
8/28/2019,2019,240,40,261,258,97,656
8/29/2019,2019,241,38,258,264,104,664
8/30/2019,2019,242,66,231,277,95,669
8/31/2019,2019,243,47,250,278,80,655
9/1/2019,2019,244,44,257,323,116,740
9/2/2019,2019,245,33,242,301,79,655
9/3/2019,2019,246,46,218,229,95,588
9/4/2019,2019,247,47,233,221,104,605
9/5/2019,2019,248,34,202,235,96,567
9/6/2019,2019,249,51,244,262,101,658
9/7/2019,2019,250,42,230,307,77,656
9/8/2019,2019,251,29,195,320,83,627
9/9/2019,2019,252,42,227,269,131,669
9/10/2019,2019,253,31,228,268,97,624
9/11/2019,2019,254,56,207,277,101,641
9/12/2019,2019,255,41,254,307,86,688
9/13/2019,2019,256,47,234,331,93,705
9/14/2019,2019,257,49,214,317,69,649
9/15/2019,2019,258,29,199,347,90,665
9/16/2019,2019,259,40,257,288,108,693
9/17/2019,2019,260,40,221,299,107,667
9/18/2019,2019,261,46,219,298,93,656
9/19/2019,2019,262,41,225,308,110,684
9/20/2019,2019,263,49,268,279,114,710
9/21/2019,2019,264,33,248,305,82,668
9/22/2019,2019,265,25,206,265,74,570
9/23/2019,2019,266,33,246,290,92,661
9/24/2019,2019,267,45,217,268,109,639
9/25/2019,2019,268,52,202,259,102,615
9/26/2019,2019,269,34,212,258,108,612
9/27/2019,2019,270,31,225,226,96,578
9/28/2019,2019,271,43,221,259,86,609
9/29/2019,2019,272,31,223,309,76,639
9/30/2019,2019,273,41,239,257,123,660
10/1/2019,2019,274,55,241,285,184,765
10/2/2019,2019,275,40,231,249,99,619
10/3/2019,2019,276,48,230,235,123,636
10/4/2019,2019,277,53,225,248,86,612
10/5/2019,2019,278,49,217,293,79,638
10/6/2019,2019,279,34,215,262,59,570
10/7/2019,2019,280,51,211,285,100,647
10/8/2019,2019,281,44,225,269,85,623
10/9/2019,2019,282,51,209,256,109,625
10/10/2019,2019,283,46,185,226,101,558
10/11/2019,2019,284,44,222,257,109,632
10/12/2019,2019,285,48,234,260,98,640
10/13/2019,2019,286,22,215,294,90,621
10/14/2019,2019,287,41,218,232,90,581
10/15/2019,2019,288,37,241,245,122,645
10/16/2019,2019,289,40,243,244,129,656
10/17/2019,2019,290,33,218,231,111,593
10/18/2019,2019,291,39,228,234,123,624
10/19/2019,2019,292,32,185,317,76,610
10/20/2019,2019,293,28,216,324,74,642
10/21/2019,2019,294,29,219,276,95,619
10/22/2019,2019,295,33,191,243,93,560
10/23/2019,2019,296,33,235,250,104,622
10/24/2019,2019,297,50,245,245,89,629
10/25/2019,2019,298,44,269,256,95,664
10/26/2019,2019,299,22,182,223,59,486
10/27/2019,2019,300,24,237,281,68,610
10/28/2019,2019,301,13,214,263,83,573
10/29/2019,2019,302,45,217,209,80,551
10/30/2019,2019,303,30,192,208,93,523
10/31/2019,2019,304,28,189,217,88,522
11/1/2019,2019,305,42,241,266,180,729
11/2/2019,2019,306,30,206,281,81,598
11/3/2019,2019,307,36,211,318,77,642
11/4/2019,2019,308,46,209,241,93,589
11/5/2019,2019,309,43,186,223,100,552
11/6/2019,2019,310,40,187,233,103,563
11/7/2019,2019,311,31,208,241,99,579
11/8/2019,2019,312,46,195,219,123,583
11/9/2019,2019,313,38,224,257,94,613
11/10/2019,2019,314,33,179,277,76,565
11/11/2019,2019,315,34,152,159,77,422
11/12/2019,2019,316,33,186,161,91,471
11/13/2019,2019,317,34,199,177,90,500
11/14/2019,2019,318,36,207,186,82,511
11/15/2019,2019,319,44,250,251,107,652
11/16/2019,2019,320,44,197,247,93,581
11/17/2019,2019,321,36,221,275,72,604
11/18/2019,2019,322,41,223,242,87,593
11/19/2019,2019,323,29,222,234,119,604
11/20/2019,2019,324,37,235,256,107,635
11/21/2019,2019,325,29,206,237,90,562
11/22/2019,2019,326,60,217,242,104,623
11/23/2019,2019,327,44,222,276,78,620
11/24/2019,2019,328,35,195,266,102,598
11/25/2019,2019,329,38,247,212,89,586
11/26/2019,2019,330,39,219,253,92,603
11/27/2019,2019,331,34,217,213,84,548
11/28/2019,2019,332,16,134,225,61,436
11/29/2019,2019,333,34,202,239,96,571
11/30/2019,2019,334,40,245,224,72,581
12/1/2019,2019,335,39,208,249,113,609
12/2/2019,2019,336,41,254,219,112,626
12/3/2019,2019,337,43,254,212,101,610
12/4/2019,2019,338,48,255,250,98,651
12/5/2019,2019,339,35,244,259,96,634
12/6/2019,2019,340,35,266,258,88,647
12/7/2019,2019,341,43,262,231,68,604
12/8/2019,2019,342,31,170,289,83,573
12/9/2019,2019,343,39,245,237,90,611
12/10/2019,2019,344,34,246,217,92,589
12/11/2019,2019,345,30,191,213,97,531
12/12/2019,2019,346,26,239,232,92,589
12/13/2019,2019,347,29,246,264,99,638
12/14/2019,2019,348,24,256,254,79,613
12/15/2019,2019,349,31,199,233,103,566
12/16/2019,2019,350,25,202,225,85,537
12/17/2019,2019,351,28,219,220,108,575
12/18/2019,2019,352,44,245,205,90,584
12/19/2019,2019,353,22,252,216,99,589
12/20/2019,2019,354,39,270,214,97,620
12/21/2019,2019,355,37,257,272,87,653
12/22/2019,2019,356,39,213,250,80,582
12/23/2019,2019,357,37,238,241,89,605
12/24/2019,2019,358,24,221,247,56,548
12/25/2019,2019,359,9,122,275,44,450
12/26/2019,2019,360,44,167,236,75,522
12/27/2019,2019,361,55,240,204,111,610
12/28/2019,2019,362,45,190,224,97,556
12/29/2019,2019,363,46,216,273,71,606
12/30/2019,2019,364,32,215,223,76,546
12/31/2019,2019,365,32,166,199,80,477
1/1/2020,2020,1,30,159,398,189,776
1/2/2020,2020,2,30,213,205,94,542
1/3/2020,2020,3,52,195,239,112,598
1/4/2020,2020,4,40,188,252,66,546
1/5/2020,2020,5,44,180,234,81,539
1/6/2020,2020,6,47,212,239,97,595
1/7/2020,2020,7,42,187,214,109,552
1/8/2020,2020,8,38,193,234,97,562
1/9/2020,2020,9,41,204,189,102,536
1/10/2020,2020,10,37,212,197,87,533
1/11/2020,2020,11,45,175,194,75,489
1/12/2020,2020,12,30,189,223,71,513
1/13/2020,2020,13,36,201,231,118,586
1/14/2020,2020,14,46,208,209,111,574
1/15/2020,2020,15,38,191,212,114,555
1/16/2020,2020,16,37,211,246,103,597
1/17/2020,2020,17,41,201,202,68,512
1/18/2020,2020,18,38,179,212,73,502
1/19/2020,2020,19,30,163,198,59,450
1/20/2020,2020,20,56,200,204,89,549
1/21/2020,2020,21,39,192,186,95,512
1/22/2020,2020,22,41,168,240,93,542
1/23/2020,2020,23,57,180,190,81,508
1/24/2020,2020,24,34,214,211,98,557
1/25/2020,2020,25,52,183,220,107,562
1/26/2020,2020,26,32,176,222,80,510
1/27/2020,2020,27,43,207,241,127,618
1/28/2020,2020,28,49,215,220,96,580
1/29/2020,2020,29,43,188,197,99,527
1/30/2020,2020,30,51,195,215,87,548
1/31/2020,2020,31,53,216,242,106,617
2/1/2020,2020,32,38,240,276,137,691
2/2/2020,2020,33,35,191,306,69,601
2/3/2020,2020,34,55,231,254,96,636
2/4/2020,2020,35,60,178,227,99,564
2/5/2020,2020,36,46,230,191,94,561
2/6/2020,2020,37,44,182,181,83,490
2/7/2020,2020,38,51,203,235,114,603
2/8/2020,2020,39,33,194,234,80,541
2/9/2020,2020,40,34,163,213,60,470
2/10/2020,2020,41,43,182,213,104,542
2/11/2020,2020,42,46,182,210,106,544
2/12/2020,2020,43,37,203,202,97,539
2/13/2020,2020,44,36,162,200,91,489
2/14/2020,2020,45,28,203,202,97,530
2/15/2020,2020,46,27,185,239,77,528
2/16/2020,2020,47,30,176,241,85,532
2/17/2020,2020,48,37,168,229,86,520
2/18/2020,2020,49,39,207,247,97,590
2/19/2020,2020,50,31,181,200,76,488
2/20/2020,2020,51,42,202,178,111,533
2/21/2020,2020,52,55,209,219,78,561
2/22/2020,2020,53,43,185,282,80,590
2/23/2020,2020,54,38,171,280,64,553
2/24/2020,2020,55,40,207,191,86,524
2/25/2020,2020,56,33,146,193,80,452
2/26/2020,2020,57,49,153,224,97,523
2/27/2020,2020,58,39,163,191,95,488
2/28/2020,2020,59,45,196,233,92,566
2/29/2020,2020,60,43,173,224,78,518
3/1/2020,2020,61,41,178,296,125,640
3/2/2020,2020,62,31,176,221,96,524
3/3/2020,2020,63,40,177,226,106,549
3/4/2020,2020,64,42,180,234,105,561
3/5/2020,2020,65,39,171,218,85,513
3/6/2020,2020,66,42,206,258,108,614
3/7/2020,2020,67,24,162,245,72,503
3/8/2020,2020,68,40,173,280,62,555
3/9/2020,2020,69,33,169,221,74,497
3/10/2020,2020,70,43,164,203,83,493
3/11/2020,2020,71,40,187,223,83,533
3/12/2020,2020,72,49,150,254,100,553
3/13/2020,2020,73,46,199,263,88,596
3/14/2020,2020,74,35,176,265,58,534
3/15/2020,2020,75,22,147,267,76,512
3/16/2020,2020,76,29,151,204,84,468
3/17/2020,2020,77,29,159,224,91,503
3/18/2020,2020,78,23,152,225,61,461
3/19/2020,2020,79,17,139,200,58,414
3/20/2020,2020,80,6,138,234,76,454
3/21/2020,2020,81,6,113,213,54,386
3/22/2020,2020,82,7,86,180,52,325
3/23/2020,2020,83,9,113,174,58,354
3/24/2020,2020,84,3,108,202,66,379
3/25/2020,2020,85,8,101,206,63,378
3/26/2020,2020,86,8,134,180,55,377
3/27/2020,2020,87,9,112,184,57,362
3/28/2020,2020,88,9,130,223,54,416
3/29/2020,2020,89,2,146,240,49,437
3/30/2020,2020,90,5,133,194,67,399
3/31/2020,2020,91,4,125,173,40,342
4/1/2020,2020,92,1,147,200,120,468
4/2/2020,2020,93,2,121,163,43,329
4/3/2020,2020,94,2,141,233,64,440
4/4/2020,2020,95,5,115,213,63,396
4/5/2020,2020,96,4,109,193,48,354
4/6/2020,2020,97,5,126,197,61,389
4/7/2020,2020,98,1,121,213,48,383
4/8/2020,2020,99,7,106,210,64,387
4/9/2020,2020,100,4,125,189,58,376
4/10/2020,2020,101,10,115,164,66,355
4/11/2020,2020,102,6,118,221,51,396
4/12/2020,2020,103,7,106,184,40,337
4/13/2020,2020,104,4,119,182,46,351
4/14/2020,2020,105,3,113,147,54,317
4/15/2020,2020,106,10,120,158,78,366
4/16/2020,2020,107,8,107,188,52,355
4/17/2020,2020,108,8,127,166,69,370
4/18/2020,2020,109,3,109,216,63,391
4/19/2020,2020,110,4,79,169,44,296
4/20/2020,2020,111,12,130,197,84,423
4/21/2020,2020,112,7,121,174,71,373
4/22/2020,2020,113,11,139,165,69,384
4/23/2020,2020,114,8,160,148,70,386
4/24/2020,2020,115,4,132,176,64,376
4/25/2020,2020,116,7,111,188,51,357
4/26/2020,2020,117,6,100,211,54,371
4/27/2020,2020,118,7,121,164,62,354
4/28/2020,2020,119,7,120,205,65,397
4/29/2020,2020,120,9,130,175,53,367
4/30/2020,2020,121,7,130,180,64,381
5/1/2020,2020,122,4,147,220,139,510
5/2/2020,2020,123,9,127,235,54,425
5/3/2020,2020,124,15,119,244,58,436
5/4/2020,2020,125,12,129,192,59,392
5/5/2020,2020,126,16,130,170,76,392
5/6/2020,2020,127,14,150,181,62,407
5/7/2020,2020,128,9,119,166,53,347
5/8/2020,2020,129,9,130,185,57,381
5/9/2020,2020,130,15,126,216,43,400
5/10/2020,2020,131,10,120,236,56,422
5/11/2020,2020,132,13,130,181,69,393
5/12/2020,2020,133,16,117,208,47,388
5/13/2020,2020,134,12,142,227,67,448
5/14/2020,2020,135,17,130,204,59,410
5/15/2020,2020,136,23,140,235,73,471
5/16/2020,2020,137,18,135,294,55,502
5/17/2020,2020,138,6,107,237,37,387
5/18/2020,2020,139,13,130,214,77,434
5/19/2020,2020,140,14,140,183,83,420
5/20/2020,2020,141,27,158,233,59,477
5/21/2020,2020,142,27,148,182,75,432
5/22/2020,2020,143,22,124,219,72,437
5/23/2020,2020,144,24,128,240,59,451
5/24/2020,2020,145,22,123,274,48,467
5/25/2020,2020,146,16,130,329,53,528
5/26/2020,2020,147,28,134,284,59,505
5/27/2020,2020,148,30,149,245,70,494
5/28/2020,2020,149,19,143,270,49,481
5/29/2020,2020,150,15,147,253,62,477
5/30/2020,2020,151,4,183,388,37,612
5/31/2020,2020,152,5,306,525,41,877
6/1/2020,2020,153,13,167,324,111,615
6/2/2020,2020,154,6,131,323,59,519
6/3/2020,2020,155,13,148,297,48,506
6/4/2020,2020,156,15,117,245,69,446
6/5/2020,2020,157,14,153,225,65,457
6/6/2020,2020,158,7,136,250,60,453
6/7/2020,2020,159,10,127,268,65,470
6/8/2020,2020,160,10,132,218,76,436
6/9/2020,2020,161,13,144,202,61,420
6/10/2020,2020,162,9,125,230,67,431
6/11/2020,2020,163,21,140,257,62,480
6/12/2020,2020,164,17,155,276,72,520
6/13/2020,2020,165,8,123,274,35,440
6/14/2020,2020,166,6,132,280,49,467
6/15/2020,2020,167,12,149,262,88,511
6/16/2020,2020,168,7,156,234,84,481
6/17/2020,2020,169,14,155,267,88,524
6/18/2020,2020,170,14,154,272,86,526
6/19/2020,2020,171,10,167,259,82,518
6/20/2020,2020,172,7,144,347,70,568
6/21/2020,2020,173,8,149,314,60,531
6/22/2020,2020,174,9,171,335,78,593
6/23/2020,2020,175,10,171,247,79,507
6/24/2020,2020,176,17,138,267,84,506
6/25/2020,2020,177,15,156,286,73,530
6/26/2020,2020,178,12,168,249,58,487
6/27/2020,2020,179,6,151,286,61,504
6/28/2020,2020,180,12,166,299,51,528
6/29/2020,2020,181,13,153,243,75,484
6/30/2020,2020,182,11,167,258,79,515
7/1/2020,2020,183,8,164,284,123,579
7/2/2020,2020,184,23,167,275,85,550
7/3/2020,2020,185,15,202,280,94,591
7/4/2020,2020,186,13,158,378,59,608
7/5/2020,2020,187,25,159,359,61,604
7/6/2020,2020,188,22,173,274,87,556
7/7/2020,2020,189,7,164,245,81,497
7/8/2020,2020,190,19,157,240,64,480
7/9/2020,2020,191,14,153,251,67,485
7/10/2020,2020,192,28,167,302,82,579
7/11/2020,2020,193,8,168,303,51,530
7/12/2020,2020,194,9,159,311,43,522
7/13/2020,2020,195,12,189,293,81,575
7/14/2020,2020,196,16,185,239,87,527
7/15/2020,2020,197,11,181,252,96,540
7/16/2020,2020,198,19,164,239,85,507
7/17/2020,2020,199,13,174,283,91,561
7/18/2020,2020,200,8,188,301,61,558
7/19/2020,2020,201,14,161,317,59,551
7/20/2020,2020,202,10,190,263,109,572
7/21/2020,2020,203,17,172,265,101,555
7/22/2020,2020,204,22,168,237,89,516
7/23/2020,2020,205,13,164,227,76,480
7/24/2020,2020,206,21,183,246,96,546
7/25/2020,2020,207,18,178,287,68,551
7/26/2020,2020,208,30,171,326,59,586
7/27/2020,2020,209,10,177,268,78,533
7/28/2020,2020,210,13,188,252,87,540
7/29/2020,2020,211,26,174,268,76,544
7/30/2020,2020,212,31,175,240,84,530
7/31/2020,2020,213,22,187,238,93,540
8/1/2020,2020,214,19,169,273,121,582
8/2/2020,2020,215,16,164,254,57,491
8/3/2020,2020,216,15,204,239,89,547
8/4/2020,2020,217,18,156,226,58,458
8/5/2020,2020,218,27,164,247,58,496
8/6/2020,2020,219,28,187,228,83,526
8/7/2020,2020,220,27,151,264,63,505
8/8/2020,2020,221,13,206,273,62,554
8/9/2020,2020,222,13,158,321,50,542
8/10/2020,2020,223,8,204,287,76,575
8/11/2020,2020,224,15,188,228,79,510
8/12/2020,2020,225,27,167,245,64,503
8/13/2020,2020,226,38,182,261,75,556
8/14/2020,2020,227,31,193,247,70,541
8/15/2020,2020,228,9,171,286,64,530
8/16/2020,2020,229,15,174,322,67,578
8/17/2020,2020,230,19,205,267,78,569
8/18/2020,2020,231,16,178,269,83,546
8/19/2020,2020,232,11,207,252,78,548
8/20/2020,2020,233,14,196,261,82,553
8/21/2020,2020,234,16,227,242,84,569
8/22/2020,2020,235,15,164,293,61,533
8/23/2020,2020,236,10,168,309,53,540
8/24/2020,2020,237,11,198,280,73,562
8/25/2020,2020,238,21,220,226,76,543
8/26/2020,2020,239,15,191,261,83,550
8/27/2020,2020,240,14,186,247,81,528
8/28/2020,2020,241,21,195,267,75,558
8/29/2020,2020,242,16,173,277,66,532
8/30/2020,2020,243,22,159,305,66,552
8/31/2020,2020,244,12,189,317,92,610
9/1/2020,2020,245,21,200,213,126,560
9/2/2020,2020,246,17,188,237,73,515
9/3/2020,2020,247,17,172,240,72,501
9/4/2020,2020,248,20,190,264,78,552
9/5/2020,2020,249,22,174,290,79,565
9/6/2020,2020,250,17,142,283,66,508
9/7/2020,2020,251,34,154,249,65,502
9/8/2020,2020,252,17,177,190,86,470
9/9/2020,2020,253,16,196,194,73,479
9/10/2020,2020,254,17,209,202,68,496
9/11/2020,2020,255,16,225,271,68,580
9/12/2020,2020,256,19,173,243,46,481
9/13/2020,2020,257,10,176,266,55,507
9/14/2020,2020,258,10,190,243,72,515
9/15/2020,2020,259,13,192,243,81,529
9/16/2020,2020,260,15,179,256,79,529
9/17/2020,2020,261,11,145,223,78,457
9/18/2020,2020,262,18,165,235,76,494
9/19/2020,2020,263,15,182,231,65,493
9/20/2020,2020,264,13,151,288,83,535
9/21/2020,2020,265,25,172,212,69,478
9/22/2020,2020,266,23,152,203,81,459
9/23/2020,2020,267,25,204,258,72,559
9/24/2020,2020,268,22,165,227,69,483
9/25/2020,2020,269,28,201,282,93,604
9/26/2020,2020,270,20,173,300,57,550
9/27/2020,2020,271,14,168,319,64,565
9/28/2020,2020,272,22,165,214,83,484
9/29/2020,2020,273,21,144,199,88,452
9/30/2020,2020,274,20,160,232,76,488
10/1/2020,2020,275,13,170,220,144,547
10/2/2020,2020,276,24,159,196,97,476
10/3/2020,2020,277,10,181,262,77,530
10/4/2020,2020,278,14,160,261,79,514
10/5/2020,2020,279,26,170,211,84,491
10/6/2020,2020,280,30,152,245,90,517
10/7/2020,2020,281,19,194,236,96,545
10/8/2020,2020,282,20,170,210,89,489
10/9/2020,2020,283,18,185,265,102,570
10/10/2020,2020,284,30,200,297,63,590
10/11/2020,2020,285,23,143,309,88,563
10/12/2020,2020,286,19,165,243,85,512
10/13/2020,2020,287,21,180,218,82,501
10/14/2020,2020,288,19,209,247,110,585
10/15/2020,2020,289,21,194,223,119,557
10/16/2020,2020,290,22,156,207,86,471
10/17/2020,2020,291,22,190,249,70,531
10/18/2020,2020,292,21,136,215,112,484
10/19/2020,2020,293,17,159,189,106,471
10/20/2020,2020,294,21,157,174,139,491
10/21/2020,2020,295,26,167,204,117,514
10/22/2020,2020,296,21,169,224,122,536
10/23/2020,2020,297,24,170,206,109,509
10/24/2020,2020,298,15,140,241,64,460
10/25/2020,2020,299,17,149,255,134,555
10/26/2020,2020,300,18,147,204,112,481
10/27/2020,2020,301,17,150,180,107,454
10/28/2020,2020,302,27,160,178,103,468
10/29/2020,2020,303,20,147,208,127,502
10/30/2020,2020,304,18,177,219,104,518
10/31/2020,2020,305,12,171,271,89,543
11/1/2020,2020,306,13,166,272,137,588
11/2/2020,2020,307,15,154,188,161,518
11/3/2020,2020,308,13,161,226,132,532
11/4/2020,2020,309,14,177,236,141,568
11/5/2020,2020,310,21,170,232,143,566
11/6/2020,2020,311,22,191,244,127,584
11/7/2020,2020,312,23,151,261,91,526
11/8/2020,2020,313,23,132,265,73,493
11/9/2020,2020,314,18,154,229,132,533
11/10/2020,2020,315,16,185,201,132,534
11/11/2020,2020,316,16,131,182,91,420
11/12/2020,2020,317,19,144,192,107,462
11/13/2020,2020,318,17,153,180,108,458
11/14/2020,2020,319,18,137,203,65,423
11/15/2020,2020,320,13,139,230,73,455
11/16/2020,2020,321,19,150,186,99,454
11/17/2020,2020,322,26,153,176,99,454
11/18/2020,2020,323,16,174,170,91,451
11/19/2020,2020,324,11,170,219,82,482
11/20/2020,2020,325,13,196,240,116,565
11/21/2020,2020,326,12,177,201,58,448
11/22/2020,2020,327,18,143,205,78,444
11/23/2020,2020,328,16,165,204,86,471
11/24/2020,2020,329,15,159,164,101,439
11/25/2020,2020,330,22,147,177,83,429
11/26/2020,2020,331,3,86,180,41,310
11/27/2020,2020,332,26,154,217,75,472
11/28/2020,2020,333,17,151,175,57,400
11/29/2020,2020,334,21,136,218,85,460
11/30/2020,2020,335,11,146,167,104,428
12/1/2020,2020,336,18,179,161,173,531
12/2/2020,2020,337,17,158,164,107,446
12/3/2020,2020,338,25,154,141,94,414
12/4/2020,2020,339,13,172,181,132,498
12/5/2020,2020,340,22,158,225,84,489
12/6/2020,2020,341,22,137,204,119,482
12/7/2020,2020,342,18,147,186,132,483
12/8/2020,2020,343,14,160,177,134,485
12/9/2020,2020,344,23,146,181,120,470
12/10/2020,2020,345,28,151,185,151,515
12/11/2020,2020,346,16,144,167,116,443
12/12/2020,2020,347,15,138,199,93,445
12/13/2020,2020,348,19,140,205,111,475
12/14/2020,2020,349,17,131,180,146,474
12/15/2020,2020,350,21,164,146,184,515
12/16/2020,2020,351,18,126,188,136,468
12/17/2020,2020,352,14,148,163,132,457
12/18/2020,2020,353,19,147,164,156,486
12/19/2020,2020,354,13,149,213,66,441
12/20/2020,2020,355,15,136,206,113,470
12/21/2020,2020,356,20,145,188,189,542
12/22/2020,2020,357,9,167,188,144,508
12/23/2020,2020,358,21,153,189,145,508
12/24/2020,2020,359,3,148,172,115,438
12/25/2020,2020,360,4,81,216,44,345
12/26/2020,2020,361,12,105,177,74,368
12/27/2020,2020,362,18,128,206,77,429
12/28/2020,2020,363,18,141,180,119,458
12/29/2020,2020,364,14,98,160,102,374
12/30/2020,2020,365,18,120,144,146,428
12/31/2020,2020,366,12,119,217,119,467
1/1/2021,2021,1,12,108,290,154,564
1/2/2021,2021,2,20,114,158,89,381
1/3/2021,2021,3,24,120,214,80,438
1/4/2021,2021,4,14,123,176,137,450
1/5/2021,2021,5,21,144,180,123,468
1/6/2021,2021,6,22,118,158,133,431
1/7/2021,2021,7,18,173,175,129,495
1/8/2021,2021,8,22,167,217,114,520
1/9/2021,2021,9,24,125,204,69,422
1/10/2021,2021,10,17,128,207,129,481
1/11/2021,2021,11,16,146,165,112,439
1/12/2021,2021,12,18,165,192,132,507
1/13/2021,2021,13,10,134,181,125,450
1/14/2021,2021,14,12,153,169,133,467
1/15/2021,2021,15,18,156,205,133,512
1/16/2021,2021,16,11,132,223,52,418
1/17/2021,2021,17,7,152,210,112,481
1/18/2021,2021,18,12,152,172,79,415
1/19/2021,2021,19,16,148,193,104,461
1/20/2021,2021,20,14,150,167,148,479
1/21/2021,2021,21,12,163,170,172,517
1/22/2021,2021,22,14,118,175,152,459
1/23/2021,2021,23,11,143,232,56,442
1/24/2021,2021,24,15,132,215,80,442
1/25/2021,2021,25,13,132,188,146,479
1/26/2021,2021,26,23,103,160,116,402
1/27/2021,2021,27,25,135,163,157,480
1/28/2021,2021,28,27,131,146,126,430
1/29/2021,2021,29,22,124,171,125,442
1/30/2021,2021,30,13,127,191,75,406
1/31/2021,2021,31,1,77,172,55,305
2/1/2021,2021,32,17,108,187,159,471
2/2/2021,2021,33,22,113,195,120,450
2/3/2021,2021,34,36,115,172,116,439
2/4/2021,2021,35,18,115,167,86,386
2/5/2021,2021,36,26,122,168,106,422
2/6/2021,2021,37,15,100,180,60,355
2/7/2021,2021,38,5,93,188,65,351
2/8/2021,2021,39,12,113,150,93,368
2/9/2021,2021,40,22,134,163,67,386
2/10/2021,2021,41,26,104,149,87,366
2/11/2021,2021,42,22,127,171,73,393
2/12/2021,2021,43,33,141,168,101,443
2/13/2021,2021,44,13,116,185,61,375
2/14/2021,2021,45,11,96,170,79,356
2/15/2021,2021,46,9,70,158,67,304
2/16/2021,2021,47,19,75,154,83,331
2/17/2021,2021,48,21,110,148,108,387
2/18/2021,2021,49,32,101,173,86,392
2/19/2021,2021,50,29,127,192,78,426
2/20/2021,2021,51,29,119,196,77,421
2/21/2021,2021,52,11,101,223,76,411
2/22/2021,2021,53,23,132,187,96,438
2/23/2021,2021,54,28,145,217,103,493
2/24/2021,2021,55,23,132,197,99,451
2/25/2021,2021,56,31,125,212,98,466
2/26/2021,2021,57,26,136,222,115,499
2/27/2021,2021,58,25,137,250,84,496
2/28/2021,2021,59,18,119,235,93,465
3/1/2021,2021,60,23,147,177,180,527
3/2/2021,2021,61,19,137,167,119,442
3/3/2021,2021,62,41,142,205,116,504
3/4/2021,2021,63,30,162,174,104,470
3/5/2021,2021,64,33,151,177,101,462
3/6/2021,2021,65,17,132,250,61,460
3/7/2021,2021,66,13,105,232,69,419
3/8/2021,2021,67,17,136,215,88,456
3/9/2021,2021,68,31,133,241,96,501
3/10/2021,2021,69,32,127,236,86,481
3/11/2021,2021,70,31,128,177,86,422
3/12/2021,2021,71,24,135,209,86,454
3/13/2021,2021,72,18,113,235,58,424
3/14/2021,2021,73,10,111,216,55,392
3/15/2021,2021,74,23,109,182,127,441
3/16/2021,2021,75,24,115,186,109,434
3/17/2021,2021,76,23,111,206,100,440
3/18/2021,2021,77,19,112,169,88,388
3/19/2021,2021,78,14,143,205,83,445
3/20/2021,2021,79,12,129,205,75,421
3/21/2021,2021,80,18,120,256,68,462
3/22/2021,2021,81,22,139,246,107,514
3/23/2021,2021,82,24,140,183,87,434
3/24/2021,2021,83,24,130,200,90,444
3/25/2021,2021,84,24,138,171,79,412
3/26/2021,2021,85,16,145,212,90,463
3/27/2021,2021,86,9,109,228,55,401
3/28/2021,2021,87,26,122,246,70,464
3/29/2021,2021,88,19,110,229,70,428
3/30/2021,2021,89,20,143,209,69,441
3/31/2021,2021,90,25,129,201,65,420
4/1/2021,2021,91,27,155,217,133,532
4/2/2021,2021,92,15,162,202,66,445
4/3/2021,2021,93,15,133,240,60,448
4/4/2021,2021,94,14,112,258,67,451
4/5/2021,2021,95,18,120,213,92,443
4/6/2021,2021,96,16,135,237,83,471
4/7/2021,2021,97,28,154,232,91,505
4/8/2021,2021,98,20,130,179,87,416
4/9/2021,2021,99,19,107,224,103,453
4/10/2021,2021,100,20,126,239,61,446
4/11/2021,2021,101,10,107,238,53,408
4/12/2021,2021,102,11,123,228,94,456
4/13/2021,2021,103,13,134,228,73,448
4/14/2021,2021,104,15,114,192,87,408
4/15/2021,2021,105,11,141,211,86,449
4/16/2021,2021,106,10,142,224,77,453
4/17/2021,2021,107,6,120,256,63,445
4/18/2021,2021,108,10,108,215,53,386
4/19/2021,2021,109,8,129,168,76,381
4/20/2021,2021,110,10,132,158,84,384
4/21/2021,2021,111,9,138,164,77,388
4/22/2021,2021,112,13,143,207,61,424
4/23/2021,2021,113,15,128,208,84,435
4/24/2021,2021,114,10,121,267,73,471
4/25/2021,2021,115,9,130,236,53,428
4/26/2021,2021,116,13,125,241,71,450
4/27/2021,2021,117,10,164,292,80,546
4/28/2021,2021,118,20,137,213,95,465
4/29/2021,2021,119,7,142,179,55,383
4/30/2021,2021,120,11,158,254,97,520
5/1/2021,2021,121,6,167,286,128,587
5/2/2021,2021,122,14,136,324,62,536
5/3/2021,2021,123,17,147,222,97,483
5/4/2021,2021,124,24,111,199,81,415
5/5/2021,2021,125,15,158,253,95,521
5/6/2021,2021,126,12,150,199,75,436
5/7/2021,2021,127,17,132,210,92,451
5/8/2021,2021,128,9,145,238,74,466
5/9/2021,2021,129,13,128,265,56,462
5/10/2021,2021,130,20,143,211,96,470
5/11/2021,2021,131,13,146,215,97,471
5/12/2021,2021,132,14,135,197,83,429
5/13/2021,2021,133,14,151,236,78,479
5/14/2021,2021,134,22,179,258,79,538
5/15/2021,2021,135,9,151,278,77,515
5/16/2021,2021,136,19,136,262,58,475
5/17/2021,2021,137,10,144,258,87,499
5/18/2021,2021,138,8,158,242,84,492
5/19/2021,2021,139,14,157,224,91,486
5/20/2021,2021,140,15,147,269,83,514
5/21/2021,2021,141,21,162,269,73,525
5/22/2021,2021,142,27,160,321,63,571
5/23/2021,2021,143,14,135,339,68,556
5/24/2021,2021,144,17,176,261,110,564
5/25/2021,2021,145,13,159,292,105,569
5/26/2021,2021,146,15,145,277,65,502
5/27/2021,2021,147,19,138,202,82,441
5/28/2021,2021,148,12,131,200,99,442
5/29/2021,2021,149,12,145,247,77,481
5/30/2021,2021,150,20,136,260,72,488
5/31/2021,2021,151,16,106,249,85,456
6/1/2021,2021,152,14,147,262,135,558
6/2/2021,2021,153,11,148,262,102,523
6/3/2021,2021,154,14,193,220,119,546
6/4/2021,2021,155,8,195,219,95,517
6/5/2021,2021,156,9,143,297,67,516
6/6/2021,2021,157,14,166,358,83,621
6/7/2021,2021,158,13,165,280,107,565
6/8/2021,2021,159,14,184,303,94,595
6/9/2021,2021,160,11,147,258,115,531
6/10/2021,2021,161,10,171,268,92,541
6/11/2021,2021,162,13,178,280,117,588
6/12/2021,2021,163,8,175,262,69,514
6/13/2021,2021,164,9,172,303,100,584
6/14/2021,2021,165,9,171,266,113,559
6/15/2021,2021,166,20,134,274,99,527
6/16/2021,2021,167,15,130,268,112,525
6/17/2021,2021,168,19,166,217,83,485
6/18/2021,2021,169,21,171,237,109,538
6/19/2021,2021,170,19,170,319,91,599
6/20/2021,2021,171,24,147,325,99,595
6/21/2021,2021,172,11,154,260,100,525
6/22/2021,2021,173,23,168,258,116,565
6/23/2021,2021,174,7,145,277,82,511
6/24/2021,2021,175,16,160,249,85,510
6/25/2021,2021,176,11,133,222,90,456
6/26/2021,2021,177,6,190,247,55,498
6/27/2021,2021,178,11,192,323,68,594
6/28/2021,2021,179,11,178,272,98,559
6/29/2021,2021,180,6,162,229,87,484
6/30/2021,2021,181,10,169,248,86,513
7/1/2021,2021,182,15,190,281,118,604
7/2/2021,2021,183,27,201,232,90,550
7/3/2021,2021,184,16,160,287,98,561
7/4/2021,2021,185,15,145,366,62,588
7/5/2021,2021,186,8,142,356,78,584
7/6/2021,2021,187,4,157,252,82,495
7/7/2021,2021,188,7,147,269,88,511
7/8/2021,2021,189,6,184,242,76,508
7/9/2021,2021,190,8,176,243,89,516
7/10/2021,2021,191,8,189,254,72,523
7/11/2021,2021,192,6,128,268,61,463
7/12/2021,2021,193,9,161,238,90,498
7/13/2021,2021,194,15,185,240,85,525
7/14/2021,2021,195,12,153,241,101,507
7/15/2021,2021,196,11,160,213,78,462
7/16/2021,2021,197,8,183,272,73,536
7/17/2021,2021,198,5,179,272,72,528
7/18/2021,2021,199,7,145,296,46,494
7/19/2021,2021,200,8,170,238,77,493
7/20/2021,2021,201,5,180,235,79,499
7/21/2021,2021,202,10,152,262,82,506
7/22/2021,2021,203,9,170,255,93,527
7/23/2021,2021,204,10,196,268,81,555
7/24/2021,2021,205,5,168,300,55,528
7/25/2021,2021,206,5,170,319,64,558
7/26/2021,2021,207,8,165,267,100,540
7/27/2021,2021,208,7,175,261,95,538
7/28/2021,2021,209,12,155,263,64,494
7/29/2021,2021,210,14,259,280,91,644
7/30/2021,2021,211,4,258,227,84,573
7/31/2021,2021,212,6,295,326,68,695
8/1/2021,2021,213,9,222,302,104,637
8/2/2021,2021,214,5,162,263,92,522
8/3/2021,2021,215,4,137,268,71,480
8/4/2021,2021,216,15,166,232,87,500
8/5/2021,2021,217,7,157,265,78,507
8/6/2021,2021,218,6,165,242,88,501
8/7/2021,2021,219,2,186,285,65,538
8/8/2021,2021,220,7,169,319,51,546
8/9/2021,2021,221,3,173,239,83,498
8/10/2021,2021,222,8,140,240,74,462
8/11/2021,2021,223,6,160,234,70,470
8/12/2021,2021,224,8,160,216,73,457
8/13/2021,2021,225,7,167,224,91,489
8/14/2021,2021,226,6,182,262,70,520
8/15/2021,2021,227,7,166,276,62,511
8/16/2021,2021,228,6,178,238,83,505
8/17/2021,2021,229,7,160,230,108,505
8/18/2021,2021,230,4,156,235,63,458
8/19/2021,2021,231,2,185,243,66,496
8/20/2021,2021,232,5,198,227,92,522
8/21/2021,2021,233,6,209,309,67,591
8/22/2021,2021,234,8,180,288,52,528
8/23/2021,2021,235,9,177,252,95,533
8/24/2021,2021,236,5,175,244,70,494
8/25/2021,2021,237,7,174,220,96,497
8/26/2021,2021,238,10,177,247,89,523
8/27/2021,2021,239,10,210,279,81,580
8/28/2021,2021,240,6,198,275,56,535
8/29/2021,2021,241,4,180,322,57,563
8/30/2021,2021,242,7,170,274,88,539
8/31/2021,2021,243,12,201,239,67,519
9/1/2021,2021,244,6,198,278,135,617
9/2/2021,2021,245,8,136,252,72,468
9/3/2021,2021,246,11,208,245,93,557
9/4/2021,2021,247,7,207,303,75,592
9/5/2021,2021,248,10,186,313,65,574
9/6/2021,2021,249,4,169,296,55,524
9/7/2021,2021,250,6,152,241,71,470
9/8/2021,2021,251,8,175,249,77,509
9/9/2021,2021,252,6,169,254,83,512
9/10/2021,2021,253,10,203,285,80,578
9/11/2021,2021,254,6,190,293,60,549
9/12/2021,2021,255,5,182,325,70,582
9/13/2021,2021,256,8,207,287,89,591
9/14/2021,2021,257,11,154,284,98,547
9/15/2021,2021,258,5,206,260,106,577
9/16/2021,2021,259,3,198,295,91,587
9/17/2021,2021,260,5,194,281,62,542
9/18/2021,2021,261,4,190,306,74,574
9/19/2021,2021,262,9,212,351,62,634
9/20/2021,2021,263,5,204,262,93,564
9/21/2021,2021,264,3,205,226,91,525
9/22/2021,2021,265,12,208,222,89,531
9/23/2021,2021,266,7,214,240,78,539
9/24/2021,2021,267,8,196,230,66,500
9/25/2021,2021,268,14,209,249,69,541
9/26/2021,2021,269,8,174,288,59,529
9/27/2021,2021,270,8,187,261,94,550
9/28/2021,2021,271,14,195,290,87,586
9/29/2021,2021,272,12,200,265,81,558
9/30/2021,2021,273,13,198,229,93,533
10/1/2021,2021,274,8,253,271,140,672
10/2/2021,2021,275,16,240,274,69,599
10/3/2021,2021,276,4,229,312,54,599
10/4/2021,2021,277,14,169,284,76,543
10/5/2021,2021,278,11,217,253,79,560
10/6/2021,2021,279,15,190,280,85,570
10/7/2021,2021,280,14,168,237,83,502
10/8/2021,2021,281,18,189,274,75,556
10/9/2021,2021,282,11,199,268,73,551
10/10/2021,2021,283,5,180,316,60,561
10/11/2021,2021,284,10,190,219,61,480
10/12/2021,2021,285,10,188,265,76,539
10/13/2021,2021,286,9,188,252,87,536
10/14/2021,2021,287,10,187,251,79,527
10/15/2021,2021,288,5,226,239,74,544
10/16/2021,2021,289,5,183,266,67,521
10/17/2021,2021,290,8,180,285,71,544
10/18/2021,2021,291,6,196,236,89,527
10/19/2021,2021,292,7,191,224,69,491
10/20/2021,2021,293,11,178,259,86,534
10/21/2021,2021,294,6,194,240,91,531
10/22/2021,2021,295,6,215,250,66,537
10/23/2021,2021,296,4,222,256,68,550
10/24/2021,2021,297,10,166,193,53,422
10/25/2021,2021,298,9,204,227,71,511
10/26/2021,2021,299,9,239,222,78,548
10/27/2021,2021,300,7,212,220,80,519
10/28/2021,2021,301,6,204,206,87,503
10/29/2021,2021,302,6,213,232,78,529
10/30/2021,2021,303,9,208,246,62,525
10/31/2021,2021,304,14,187,307,51,559
11/1/2021,2021,305,8,196,231,115,550
11/2/2021,2021,306,9,194,236,80,519
11/3/2021,2021,307,8,200,249,61,518
11/4/2021,2021,308,12,165,235,79,491
11/5/2021,2021,309,14,178,233,59,484
11/6/2021,2021,310,9,212,263,67,551
11/7/2021,2021,311,9,188,286,64,547
11/8/2021,2021,312,3,195,278,82,558
11/9/2021,2021,313,7,196,241,88,532
11/10/2021,2021,314,8,214,246,88,556
11/11/2021,2021,315,10,196,209,59,474
11/12/2021,2021,316,12,196,174,94,476
11/13/2021,2021,317,12,190,230,65,497
11/14/2021,2021,318,9,191,232,46,478
11/15/2021,2021,319,9,193,218,90,510
11/16/2021,2021,320,12,196,233,71,512
11/17/2021,2021,321,12,180,177,80,449
11/18/2021,2021,322,13,180,210,84,487
11/19/2021,2021,323,4,202,224,67,497
11/20/2021,2021,324,16,194,247,71,528
11/21/2021,2021,325,2,185,261,54,502
11/22/2021,2021,326,5,155,210,71,441
11/23/2021,2021,327,7,175,179,60,421
11/24/2021,2021,328,11,217,209,82,519
11/25/2021,2021,329,3,105,216,35,359
11/26/2021,2021,330,8,181,198,81,468
11/27/2021,2021,331,5,210,197,48,460
11/28/2021,2021,332,7,144,273,64,488
11/29/2021,2021,333,6,215,210,85,516
11/30/2021,2021,334,13,209,194,74,490
12/1/2021,2021,335,13,226,229,120,588
12/2/2021,2021,336,14,184,253,80,531
12/3/2021,2021,337,7,235,254,82,578
12/4/2021,2021,338,7,205,226,63,501
12/5/2021,2021,339,3,174,237,57,471
12/6/2021,2021,340,8,205,217,61,491
12/7/2021,2021,341,8,169,215,70,462
12/8/2021,2021,342,8,199,222,91,520
12/9/2021,2021,343,7,211,213,72,503
12/10/2021,2021,344,8,200,225,72,505
12/11/2021,2021,345,12,211,200,50,473
12/12/2021,2021,346,8,191,260,60,519
12/13/2021,2021,347,8,197,231,72,508
12/14/2021,2021,348,7,197,212,70,486
12/15/2021,2021,349,7,229,219,75,530
12/16/2021,2021,350,9,214,218,60,501
12/17/2021,2021,351,5,204,215,65,489
12/18/2021,2021,352,15,189,232,54,490
12/19/2021,2021,353,7,147,209,67,430
12/20/2021,2021,354,4,188,202,78,472
12/21/2021,2021,355,4,164,203,53,424
12/22/2021,2021,356,7,195,157,64,423
12/23/2021,2021,357,5,199,202,55,461
12/24/2021,2021,358,12,169,198,65,444
12/25/2021,2021,359,2,112,235,48,397
12/26/2021,2021,360,4,121,203,63,391
12/27/2021,2021,361,9,174,210,58,451
12/28/2021,2021,362,5,148,196,57,406
12/29/2021,2021,363,5,184,182,69,440
12/30/2021,2021,364,3,195,229,60,487
12/31/2021,2021,365,8,153,264,78,503
